##########################
#          4          #  #
#          4             #
#   4      4     #00#    #
#0  ###33####33######4433#
#1  3     #      40 03   #
###########44#############
#  0          2          #
#             2         5#
#             2    222  ##
#4433444#2222###         #
#    #         #44       #
##   #   3     #  22443  #
###  #33###2233#         #
###     2 0    ##       0#
##########################