#########################
#   2   0   #   0   4   #
#   2   0   3   0   4   #
#1  #   0   3   0   #   #
######################44#
#    0                  #
#    0                  #
# ######                #
# #    # 333            #
# #           444       #
# #44         4 44    ###
# #  #        4      ####
# #  #22###   2       ###
#5#0      3   2    ######
#########################
