###############
# 2 #         #
#   #         #
#   #  #####  #
# ###   1  #  #
#   ########  #
#         ##  #
#   ###       #
###############